NO ./tex/wall_1.xpm
SO ./tex/wall_2.xpm
WE ./tex/wall_3.xpm
EA ./tex/wall_4.xpm

C 0,0,33
F 60,179,110

1111111
1N00001
1111111