NO ./tex/wall_1.xpm
SO ./tex/wall_2.xpm
WE ./tex/wall_3.xpm
EA ./tex/wall_4.xpm

F 220,     100, 0
C 110,       30, 0

1111111
1N00001
1101111
11111111
11111101
100000011
1111111111