NO ./tex/wall_1.xpm
SO ./tex/wall_2.xpm
WE ./tex/wall_3.xpm
EA ./tex/wall_4.xpm

F 220,     100, 001
C 110,       30, 000

11111111
10000021
1N000011
11111111