NO ./tex/wall_1.xpm
SO ./tex/wall_2.xpm
WE ./tex/wall_3.xpm
EA ./tex/wall_4.xpm
F 220,100,0
C 225,30,0

        1111111111111111111111111
        1000000000110000000000001
        1011000001110000000000001
        1001000000000000000000001
111111111011000001110000000000001
100000000011000001110101110111111
11110111111111011100000010001
11110111111111011101010010001
11000000110101011100000010001
10000000000000001100000010001
10000000000000001101010000001
1100000111010101111101111000111
11110111 1110101 10111101N001
11111111 1111111 111111111111