NO ./tex/wall_1.xpm
SO ./tex/wall_2.xpm
WE ./tex/wall_3.xpm
EA ./tex/wall_4.xpm
F 220,100,0
C 225,30,0

1111111111
1001210001
1000000001
1000000001
1000000001
1000010001
1000001001
1000000001
1000N00001
1111111111



1111111111111111
100N1
111 1
1111111111111111



1111111111111111
100N1
111
111111111111111



1111111111111111
10000000000000N1


1
N1
1