NO  ./tex/wall_1.xpm
SO   ./tex/wall_2.xpm
WE      ./tex/wall_3.xpm
EA      ./tex/wall_4.xpm
F       220,100,0
C       225,30,0





111111111111111
100000000000001
100000000000001
100000000000001
1000000000000N1
111111111111111