NO  ./tex/wall_1.xpm
SO   ./tex/wall_2.xpm
WE      ./tex/wall_3.xpm
EA      ./tex/wall_4.xpm
F       220,100,0
C       225,30,0





111111111111111
100000000000001
101111011111101
101000010000101
101011110110101
101010N0010101
101111011111101
100000000000001
111111111111111