NO  ./textures/wall_1.xpm
SO   ./textures/wall_2.xpm
WE      ./textures/wall_3.xpm
EA      ./textures/wall_4.xpm
F 220,100,0        
C 225,30,0





1111111111
1001210001
10000000N1
1111111111
1001210001
1000000001
1111111111



