NO ./tex/wall_1.xpm
SO ./tex/wall_2.xpm
WE ./tex/wall_3.xpm
EA  ./tex/wall_4.xpm




C   225, 30 , 0


F   220 , 100, 0






 1111
 1001
  1001
   1001
    1001
     1001
      1001
       10W1
       1111 111
            101
            111